111111111111
000100100001
101101101101
100000100101
111101111101
100000000000
111111111111